// ### Furniture ###
// Lighting
torch=火把
lightsource=光源
walltorch=壁式火把
ironlamp=铁灯
goldlamp=金灯
firechalice=火焰圣杯
templefirechalice=圣殿火焰圣杯
copperstreetlamp=铜路灯
copperdoublestreetlamp=铜双头路灯
ironstreetlamp=铁路灯
irondoublestreetlamp=铁双头路灯
goldstreetlamp=金路灯
golddoublestreetlamp=金双头路灯
tungstenstreetlamp=钨路灯
tungstendoublestreetlamp=钨双头路灯
oillantern=油灯
lantern=提灯
walllantern=壁灯
waterlantern=水灯
candle=蜡烛
wallcandle=壁烛
stonecandlepedestal=石烛台
snowcandlepedestal=雪烛台
swampcandlepedestal=沼泽烛台
desertcandlepedestal=沙漠烛台
tikitorch=提基火把
basalttorch=玄武火把
wallbasalttorch=玄武壁式火把
arcaniclamp=奥术灯
wallarcaniclamp=奥术壁灯
woodencandleset=木质烛台套装
swampcandlestand=沼泽烛台
swampcandlestandduo=双头沼泽烛台
brazier=火盆

// Misc
sign=木牌
flowerpot=花盆
decorativepot=装饰罐子
pottedplant=植物盆栽
pottedflower=鲜花盆栽
pottedcactus=仙人掌盆栽
bonsaitree=盆景树
itemstand=物品展示台
armorstand=盔甲架
trainingdummy=训练假人
snowmantrainingdummy=雪人
stonecoffin=石棺
cryptcoffin=墓穴棺
basaltcoffin=玄武石棺
gravestone=墓碑
minecarttrack=矿车轨道
traptrack=陷阱轨道
skull=头骨
mosscoveredskull=覆苔头骨
bloodstains=血迹
fallenicicle=坠落冰锥
fallingicicletrigger=坠落冰锥触发器
bloodgoblet=高脚杯
bloodgobletspilled=倾倒的高脚杯
swampstonecase=沼泽石箱
tableclock=台钟
dogplush=狗狗毛绒玩具
dryadspiritcage=树灵灵魂笼
dinoplush=恐龙毛绒玩具
plate=盘子
mug=马克杯
teapot=茶壶
diningset=餐具
bluediningset=蓝色餐具
reddiningset=红色餐具
dirtyplate=脏盘子
dirtydishes=脏餐具
stewpot=炖锅
cuttingboard=砧板
utensilrack=器皿架
papertowel=厨房纸巾
stackofpaper=一叠纸
greenandpinkbooks=绿色与粉色的书
redbooks=红色的书
blueandyellowbooks=蓝色和黄色的书
yellowbook=黄色的书
greenbook=绿色的书
orangebook=橙色的书
stackedbooks=堆叠的书
quillandparchment=羽毛笔和羊皮纸
observantmask=洞悉面具
unamusedmask=无相面具
farseersorb=预言球
fishonastick=罹难鱼·木刺
voidcube=虚空方块
relicofthedepths=深渊的遗物
largeglobe=大型地球仪
emptyglassdisplay=空玻璃展架
brokenglassdisplay=破碎的玻璃展架
beetglassdisplay=甜菜玻璃展架
brokenherbglassdisplay=破碎的草药玻璃展架
caveglowglassdisplay=洞穴辉光玻璃展架
experimentalroot=培育根茎
testtubes=试管
voidflaskandtesttube=空烧瓶和试管
voidflasks=空烧瓶
blueberryandcornextract=蓝莓和玉米提取物
caveglowflask=洞穴辉光烧瓶
stuffedpig=填料烤猪
spilledgoldchalice=倾倒的金圣杯
goldchalice=金圣杯
oldplate=旧盘子
rottenpigdish=腐烂的猪料理
rottenfishstew=腐烂的炖鱼
oldsoup=陈腐浓汤
brokenplate=碎盘子
simplesculpture=简易雕塑
oldchalices=旧圣杯
forgottenblade=遗忘之刃
duelistclock=决斗计时钟
halfeatenduck=吃剩的烤鸭
roastedduck=烤鸭
leftovertray=剩菜托盘
picnicblanket=野餐毯
steppingstones=踏脚石
largesteppingstone=大踏脚石
mossysteppingstones=苔覆踏脚石
largemossysteppingstone=苔覆大踏脚石

// Furniture types
// Oak
oakchest=橡木箱子
oakdinnertable=橡木餐桌
oakdesk=橡木桌
oakmodulartable=橡木组合桌
oakchair=橡木椅
oakbench=橡木长椅
oakbookshelf=橡木书架
oakcabinet=橡木柜
oakbed=橡木床
oakdoublebed=橡木双人床
oakdresser=橡木梳妆台
oakclock=橡木座钟
oakcandelabra=橡木烛台
oakdisplay=橡木展示台
oakbathtub=橡木浴缸
oaktoilet=橡木马桶

// Spruce
sprucechest=云杉箱子
sprucedinnertable=云杉餐桌
sprucedesk=云杉桌
sprucemodulartable=云杉组合桌
sprucechair=云杉椅
sprucebench=云杉长椅
sprucebookshelf=云杉书架
sprucecabinet=云杉柜
sprucebed=云杉床
sprucedoublebed=云杉双人床
sprucedresser=云杉梳妆台
spruceclock=云杉座钟
sprucecandelabra=云杉烛台
sprucedisplay=云杉展示台
sprucebathtub=云杉浴缸
sprucetoilet=云杉马桶

// Pine
pinechest=松木箱子
pinedinnertable=松木餐桌
pinedesk=松木桌
pinemodulartable=松木组合桌
pinechair=松木椅
pinebench=松木长椅
pinebookshelf=松木书架
pinecabinet=松木柜
pinebed=松木床
pinedoublebed=松木双人床
pinedresser=松木梳妆台
pineclock=松木座钟
pinecandelabra=松木烛台
pinedisplay=松木展示台
pinebathtub=松木浴缸
pinetoilet=松木马桶

// Palm
palmchest=棕榈木箱子
palmdinnertable=棕榈木餐桌
palmdesk=棕榈木桌
palmmodulartable=棕榈木组合桌
palmchair=棕榈木椅
palmbench=棕榈木长椅
palmbookshelf=棕榈木书架
palmcabinet=棕榈木柜
palmbed=棕榈木床
palmdoublebed=棕榈木双人床
palmdresser=棕榈木梳妆台
palmclock=棕榈木座钟
palmcandelabra=棕榈木烛台
palmdisplay=棕榈木展示台
palmbathtub=棕榈木浴缸
palmtoilet=棕榈木马桶
willowchest=柳木箱子
willowdinnertable=柳木餐桌
willowdesk=柳木桌
willowmodulartable=柳木组合桌
willowchair=柳木椅
willowbench=柳木长椅
willowbookshelf=柳木书架
willowcabinet=柳木柜
willowbed=柳木床
willowdoublebed=柳木双人床
willowdresser=柳木梳妆台
willowclock=柳木座钟
willowcandelabra=柳木烛台
willowdisplay=柳木展示台
willowbathtub=柳木浴缸
willowtoilet=柳木马桶
maplechest=枫木箱子
mapledinnertable=枫木餐桌
mapledesk=枫木桌
maplemodulartable=枫木组合桌
maplechair=枫木椅
maplebench=枫木长椅
maplebookshelf=枫木书架
maplecabinet=枫木柜
maplebed=枫木床
mapledoublebed=枫木双人床
mapledresser=枫木梳妆台
mapleclock=枫木座钟
maplecandelabra=枫木烛台
mapledisplay=枫木展示台
maplebathtub=枫木浴缸
mapletoilet=枫木马桶
birchchest=桦木箱子
birchdinnertable=桦木餐桌
birchdesk=桦木桌
birchmodulartable=桦木组合桌
birchchair=桦木椅
birchbench=桦木长椅
birchbookshelf=桦木书架
birchcabinet=桦木柜
birchbed=桦木床
birchdoublebed=桦木双人床
birchdresser=桦木梳妆台
birchclock=桦木座钟
birchcandelabra=桦木烛台
birchdisplay=桦木展示台
birchbathtub=桦木浴缸
birchtoilet=桦木马桶

// Dungeon
dungeonchest=地牢箱子
dungeondinnertable=地牢餐桌
dungeondesk=地牢桌
dungeonmodulartable=地牢组合桌
dungeonchair=地牢椅
dungeonbench=地牢长椅
dungeonbookshelf=地牢书架
dungeoncabinet=地牢柜
dungeonbed=地牢床
dungeondoublebed=地牢双人床
dungeondresser=地牢梳妆台
dungeonclock=地牢座钟
dungeoncandelabra=地牢烛台
dungeondisplay=地牢展示台
dungeonbathtub=地牢浴缸
dungeontoilet=地牢马桶
bonechest=骨制箱子
bonedinnertable=骨制餐桌
bonedesk=骨制桌
bonemodulartable=骨制组合桌
bonechair=骨制椅
bonebench=骨制长椅
bonebookshelf=骨制书架
bonecabinet=骨制柜
bonebed=骨制床
bonedoublebed=骨制双人床
bonedresser=骨制梳妆台
boneclock=骨制座钟
bonecandelabra=骨制烛台
bonedisplay=骨制展示台
bonebathtub=骨制浴缸
bonetoilet=骨制马桶
dryadchest=树灵箱子
dryaddinnertable=树灵餐桌
dryaddesk=树灵桌
dryadmodulartable=树灵组合桌
dryadchair=树灵椅
dryadbench=树灵长椅
dryadbookshelf=树灵书架
dryadcabinet=树灵柜
dryadbed=树灵床
dryaddoublebed=树灵双人床
dryaddresser=树灵梳妆台
dryadclock=树灵座钟
dryadcandelabra=树灵烛台
dryaddisplay=树灵展示台
dryadbathtub=树灵浴缸
dryadtoilet=树灵马桶
bamboochest=竹制箱子
bamboodinnertable=竹制餐桌
bamboodesk=竹制桌
bamboomodulartable=竹制组合桌
bamboochair=竹制椅
bamboobench=竹制长椅
bamboobookshelf=竹制书架
bamboocabinet=竹制柜
bamboobed=竹制床
bamboodoublebed=竹制双人床
bamboodresser=竹制梳妆台
bambooclock=竹制座钟
bamboocandelabra=竹制烛台
bamboodisplay=竹制展示台
bamboobathtub=竹制浴缸
bambootoilet=竹制马桶
deadwoodchest=枯木箱子
deadwooddinnertable=枯木餐桌
deadwooddesk=枯木桌
deadwoodmodulartable=枯木组合桌
deadwoodchair=枯木椅
deadwoodbench=枯木长椅
deadwoodbookshelf=枯木书架
deadwoodcabinet=枯木柜
deadwoodbed=枯木床
deadwooddoublebed=枯木双人床
deadwooddresser=枯木梳妆台
deadwoodclock=枯木座钟
deadwoodcandelabra=枯木烛台
deadwoodcandles=枯木蜡烛
deadwooddisplay=枯木展示台
deadwoodbathtub=枯木浴缸
deadwoodtoilet=枯木马桶
spiderthrone=蛛魔王座
spidercastlecandelabra=蛛魔城堡烛台
spidercastlewallcandle=蛛魔城堡壁烛台
spidercastlemodulartable=蛛魔城堡组合桌
spidercastlechair=蛛魔城堡椅
spidercastlebench=蛛魔城堡长椅
spidercastlebookshelf=蛛魔城堡书架
spideritearmorstand=蛛裔盔甲架
emptyravennest=空的渡鸦巢穴
ravennestwithegg=渡鸦巢穴
ravenskull=渡鸦头骨
arcanicmachinery=奥术机械
largekeg=大酒桶
stool=酒凳
sink=水槽
tungstensink=钨制水槽
barshelf=酒架

// Carpets
woolcarpet=羊毛地毯
leathercarpet=皮质地毯
brownbearcarpet=棕熊地毯
bluecarpet=蔚蓝地毯
goldgridcarpet=金纹地毯
greencarpet=绿鳞地毯
heartcarpet=爱之地毯
purplecarpet=紫点地毯
redyarncarpet=赤纱地毯
steelgreycarpet=钢灰地毯
velourcarpet=丝绒地毯
groundslime=史莱姆地毯

// Processing
campfire=营火
cookingpot=烹饪锅
roastingstation=烧烤台
cookingstation=烹饪工作站
compostbin=堆肥桶
grainmill=风车磨坊
cheesepress=压酪机
feedingtrough=喂食盆

rock=岩石
sandstonerock=沙石
swamprock=沼泽岩石
snowrock=雪地岩石
graniterock=花岗岩石
deeprock=深层岩石
deepsnowrock=深层雪地岩石
basaltrock=玄武岩石
deepswamprock=深层沼泽岩石
deepsandstonerock=深层沙石
slimerock=史莱姆岩石
spiderrock=蜘蛛岩石
cryptrock=墓穴岩石
crystal=水晶
pearlescentshard=珠光碎片
ascendedwall=晋升之墙
ascendedpylon=晋升之塔
amethystcluster=紫水晶簇
amethystclusterpure=纯紫水晶簇
amethystcluster_small=小紫水晶簇
sapphirecluster=蓝水晶簇
sapphireclusterpure=纯蓝水晶簇
sapphirecluster_small=小蓝水晶簇
emeraldcluster=翡翠簇
emeraldclusterpure=纯翡翠簇
emeraldcluster_small=小翡翠簇
rubycluster=红宝石簇
rubyclusterpure=纯红宝石簇
rubycluster_small=小红宝石簇
topazcluster=托帕石簇
topazclusterpure=纯托帕石簇
topazcluster_small=小托帕石簇

clayrock=粘土岩
obsidianrock=黑曜石
SAME_TRANSLATION:rockoreformat=<rock> <ore>

ironore=铁矿石
copperore=铜矿石
goldore=金矿石
frostshardore=冰霜碎片
runicboulder=符文巨石
smallrunestone=小型符文石
ivyore=常春藤矿石
quartzore=石英
tungstenore=钨矿石
lifequartzore=生命石英
glacialore=冰川矿石
amberore=琥珀矿石
myceliumore=菌丝矿石
ancientfossilore=远古化石矿石
alchemyshardore=炼金碎片矿石
upgradeshardore=升级碎片矿石
slimeum=史莱姆矿石
nightsteelore=夜铁矿石
spideriteore=蛛裔矿石
pearlescentdiamond=珠光钻石

// Misc
grass=草
swampgrass=沼泽草
plainsgrass=平原草
tallswampgrass=高沼泽草
cryptgrass=墓穴草
cattail=香蒲
reeds=芦苇
watergrass=水草
cavewatergrass=洞穴水草
glowcoral=发光珊瑚
snowpile=积雪
leafpile=树叶堆
cobweb=蜘蛛网
thorns=荆棘
seashell=贝壳
seasnail=海螺
seastar=海星
bamboodebris=竹子碎片
swamproot=沼泽根
cowskeleton=牛骨
katanastone=武士刀之石
caveladder=洞穴梯子
dungeonentrance=地牢入口
trialentrance=试炼入口
trialexit=试炼出口
dungeonexit=地牢出口
deepcaveladder=深层洞穴梯子
templeentrance=圣殿入口
templeexit=圣殿出口
fallenaltar=堕落祭坛
upgradestation=升级工作站
salvagestation=回收工作站
tictactoeboard=井字棋盘
coinstack=金币堆
crate=箱
snowcrate=雪地箱
swampcrate=沼泽箱
christmascrate=圣诞箱
arcaniccrate=奥术箱
vase=花瓶
swampspore=沼泽孢子
ancienttotem=远古图腾
templepedestal=神殿基座
chieftainbonespikewall=骨刺墙
bonespikewall=骨刺墙
chieftainspedestal=酋长基座
settlementflag=营地旗帜
homestone=回城石碑
waystone=路径石碑
teleportationstone=传送石碑
missionboard=任务看板
shippingchest=货运箱
bannerstand=旗帜架
bannerofpeace=和平旗帜
bannerofwar=战争旗帜
challengersbanner=挑战者旗帜
musicplayer=音乐播放器
cartographertable=制图师桌子
spideregg=蜘蛛蛋
christmastree=圣诞树
christmaswreath=圣诞花环
fountain=喷泉
overgrownfountain=杂草丛生的喷泉
bloodfountain=血泉
beetcavecroppler=奇特的红甜菜
chieftainsthrone=符缚酋长王座
frostbanner=冰霜旗帜
largefrostbanner=大型冰霜旗帜
dryadbanner=树灵旗帜
largedryadbanner=大型树灵旗帜
eggcellentbanner=蛋胜旗帜
largeeggcellentbanner=大型蛋胜旗帜
fishianbanner=鱼人旗帜
largefishianbanner=大型鱼人旗帜
piratebanner=海盗旗帜
largepiratebanner=大型海盗旗帜
vampiricbanner=吸血鬼旗帜
largevampiricbanner=大型吸血鬼旗帜
voidvessel=虚空容器


[item]
material=素材
// General materials
coin=金币
oaklog=橡木
sprucelog=云杉木
pinelog=松木
palmlog=棕榈木
willowlog=柳木
maplelog=枫木
birchlog=桦木
bamboo=竹子
deadwoodlog=枯木
dryadlog=树灵木
stone=石头
sandstone=沙石
swampstone=沼泽岩石
snowstone=雪地岩石
granite=花岗岩
deepstone=深层岩石
deepsnowstone=深层雪地岩石
basalt=玄武岩石
deepswampstone=深层沼泽岩石
deepsandstone=深层沙岩
cryptstone=墓穴岩石
spiderstone=蜘蛛岩石
batwing=蝙蝠翅膀
silk=丝绸
wormcarapace=蠕虫甲壳
phantomdust=幻影尘土
honeybee=蜜蜂
queenbee=蜂后
apiaryframe=蜂巢框
wool=羊毛
egg=蛋
leather=皮革
clothscraps=碎布料
clay=粘土
amethyst=紫水晶
sapphire=蓝宝石
emerald=翡翠
ruby=红宝石
topaz=托帕石
copperore=铜矿石
copperbar=铜锭
ironore=铁矿石
ironbar=铁锭
goldore=金矿石
goldbar=金锭
frostshard=冰霜碎片
runestone=符文石
ivyore=常春藤矿石
ivybar=常春藤锭
quartz=石英
lifequartz=生命石英
demonicbar=恶魔锭
tungstenore=钨矿石
tungstenbar=钨锭
glacialore=冰川矿石
glacialbar=冰川锭
amber=琥珀
myceliumore=菌丝矿石
myceliumbar=菌丝锭
ancientfossilore=远古化石矿石
ancientfossilbar=远古化石锭
obsidian=黑曜石
slimeum=史莱姆矿石
nightsteelore=夜铁矿石
nightsteelbar=夜铁锭
spideriteore=蛛裔矿石
spideritebar=蛛裔锭
pearlescentdiamond=珠光钻石
cavespidergland=洞穴蜘蛛腺体
voidshard=虚空残片
swampsludge=沼泽淤泥
bone=骨头
ectoplasm=流质
slimematter=史莱姆物质
spidervenom=蛛毒
omnicrystal=全能水晶
glacialshard=冰川残片
glass=玻璃
glassbottle=玻璃瓶
book=书本
alchemyshard=炼金碎片
upgradeshard=升级碎片
ascendedshard=晋升碎片
shadowessence=暗影精华
cryoessence=急冻精华
bioessence=生物精华
primordialessence=原始精华
slimeessence=史莱姆精华
bloodessence=鲜血精华
spideressence=蜘蛛精华
altardust=祭坛尘埃
ravenfeather=渡鸦之羽
electrifiedmana=充能魔力
carp=鲤鱼
cod=鳕鱼
herring=鲱鱼
mackerel=马鲛鱼
salmon=鲑鱼
trout=鳟鱼
tuna=金枪鱼
gobfish=戈布鱼
terrorfish=恐惧之鱼
halffish=半鱼
rockfish=岩鱼
furfish=毛皮之鱼
icefish=冰霜之鱼
swampfish=沼泽之鱼
mapfragment=地图碎片
map=地图
spareboatparts=备用船舶零件
brokencoppertool=损坏的铜器
brokenirontool=损坏的铁器
pickaxe=镐

// Pickaxes
woodpickaxe=木镐
copperpickaxe=铜镐
ironpickaxe=铁镐
goldpickaxe=金镐
frostpickaxe=冰霜镐
demonicpickaxe=恶魔镐
runicpickaxe=符文镐
ivypickaxe=常春藤镐
quartzpickaxe=石英镐
tungstenpickaxe=钨镐
glacialpickaxe=冰川镐
dryadpickaxe=树灵镐
icepickaxe=冰镐
myceliumpickaxe=菌丝镐
ancientfossilpickaxe=古代化石镐
axe=斧

// Axes
woodaxe=木斧
copperaxe=铜斧
ironaxe=铁斧
goldaxe=金斧
frostaxe=冰霜斧
demonicaxe=恶魔斧
runicaxe=符文斧
ivyaxe=常春藤斧
quartzaxe=石英斧
tungstenaxe=钨斧
glacialaxe=冰川斧
dryadaxe=树灵斧
myceliumaxe=菌丝斧
ancientfossilaxe=古代化石斧
shovel=铲

// Shovels
woodshovel=木铲
coppershovel=铜铲
ironshovel=铁铲
goldshovel=金铲
frostshovel=冰霜铲
runicshovel=符文铲
ivyshovel=常春藤铲
quartzshovel=石英铲
demonicshovel=恶魔铲
tungstenshovel=钨铲
glacialshovel=冰川铲
dryadshovel=树灵铲
myceliumshovel=菌丝铲
ancientfossilshovel=古代化石铲
fishingrod=钓竿

// Fishing rods
godrod=神级钓竿
woodfishingrod=木钓竿
ironfishingrod=铁钓竿
overgrownfishingrod=丛生植物钓竿
goldfishingrod=金钓竿
depthscatcher=深水捕集器
bait=鱼饵

// Bait
godbait=神级鱼饵
wormbait=蠕虫鱼饵
swamplarva=沼泽虫鱼饵
anglersbait=渔人鱼饵

// Misc tools
sickle=镰刀
farmingscythe=农用镰刀
wrench=扳手
cutter=切割机
wire=导线
net=网
multitool=多功能工具
eraser=橡皮擦
pipette=取物管
sword=剑
closerangeweapon=近程武器
meleeweapon=近战武器
incursioncloserangeweapon=副本近程武器

// Swords
woodsword=木剑
coppersword=铜剑
ironsword=铁剑
goldsword=金剑
frostsword=冰霜剑
nunchucks=双节棍
katana=武士刀
heavyhammer=沉重之锤
lightninghammer=雷霆之锤
galvanichammer=迸雷之锤
demonicsword=恶魔剑
spiderclaw=蜘蛛之爪
ivysword=常春藤剑
cutlass=海盗弯刀
amethystsword=紫水晶剑
reinforcedkatana=强化武士刀
tungstensword=钨剑
reaperscythe=死神镰刀
barkblade=树皮刃
sandknife=砂刃
venomslasher=毒液剑
agedchampionsword=历战王剑
antiquesword=上古剑
bloodclaw=血爪
thecrimsonsky=猩红苍穹
causticexecutioner=腐蚀处刑者
gemstonelongsword=宝石长剑
perfectstorm=完美风暴
voidclaw=虚空利爪
greatsword=巨剑
incursiongreatsword=副本巨剑
irongreatsword=铁巨剑
frostgreatsword=冰霜巨剑
brutesbattleaxe=野蛮战斧
necroticgreatsword=死灵巨剑
hexedbladegreatsword=咒缚之刃
ivygreatsword=常春藤巨剑
quartzgreatsword=石英巨剑
glacialgreatsword=冰川巨剑
dryadgreathammer=树灵巨锤
slimegreatsword=史莱姆巨剑
ravenwinggreatsword=渡鸦之翼
spear=矛
incursionspear=副本矛

// Spears
woodspear=木矛
copperpitchfork=铜叉
copperspear=铜矛
ironspear=铁矛
goldspear=金矛
frostspear=冰霜矛
demonicspear=恶魔矛
voidspear=虚空矛
ivyspear=常春藤矛
vulturestalon=秃鹫利爪
tungstenspear=钨矛
cryospear=冰矛
ravenbeakspear=渡鸦尖矛
glaive=阔剑
incursionglaive=副本阔剑

// Glaives
goldglaive=金阔剑
frostglaive=冰霜阔剑
quartzglaive=石英阔剑
cryoglaive=急冻阔剑
slimeglaive=史莱姆阔剑
rangedweapon=远程武器
bow=弓
incursionbow=副本弓

// Bows
woodbow=木弓
copperbow=铜弓
ironbow=铁弓
goldbow=金弓
frostbow=冰霜弓
captorsshortbow=捕手短弓
demonicbow=恶魔弓
ivybow=常春藤弓
vulturesburst=秃鹫神速
tungstenbow=钨弓
glacialbow=冰川弓
dryadbow=树灵弓
bowofdualism=双重弓
antiquebow=远古弓
arachnidwebbow=蛛网弓
ascendedbow=晋升弓
greatbow=巨弓
incursiongreatbow=副本巨弓
goldgreatbow=金巨弓
voidgreatbow=虚空巨弓
ivygreatbow=常春藤巨弓
tungstengreatbow=钨巨弓
myceliumgreatbow=菌丝巨弓
druidsgreatbow=德鲁伊弓
nightpiercer=刺穿黑夜
theravensnest=渡鸦之巢
arrow=箭矢

// Arrows
stonearrow=石箭
firearrow=焰火箭
frostarrow=冰霜箭
poisonarrow=剧毒箭
bouncingarrow=弹跳箭
ironarrow=铁箭
bonearrow=骨箭
spideritearrow=蛛裔箭
gun=枪
incursiongun=副本枪

// Guns
handgun=手枪
sapphirerevolver=蓝宝石左轮枪
webbedgun=织网枪
sniperrifle=狙击步枪
sixshooter=六发左轮
machinegun=机枪
shotgun=霰弹枪
flintlock=燧发枪
handcannon=便携加农炮
deathripper=亡者之悼
cryoblaster=冰之爆裂
livingshotty=活体枪
antiquerifle=远古步枪
shardcannon=碎片加农炮
snowlauncher=雪球发射器
seedgun=种子枪
bullet=子弹

// Bullets
simplebullet=简易子弹
frostbullet=冰霜子弹
bouncingbullet=弹跳子弹
voidbullet=虚空子弹
cannonball=炮弹
crystalbullet=水晶子弹
magicweapon=魔法武器
incursionmagicweapon=副本魔法武器

// Magic weapons
bloodbolt=鲜血迸发
bloodvolley=血色绽放
froststaff=霜星法杖
voidstaff=虚空法杖
voidmissile=虚空导弹
swamptome=沼泽之典
necroticflask=死灵魔瓶
unlabeledpotion=无名药水
genielamp=精灵神灯
vampiriclamp=吸血灯
woodstaff=木法杖
sparkler=火花
sprinkler=水花
venomstaff=毒液法杖
dredgingstaff=淤泥法杖
boulderstaff=巨石法杖
quartzstaff=石英法杖
elderlywand=古老魔杖
shadowbolt=暗影导弹
chromaticspellbook=炫彩魔法书
iciclestaff=冰柱法杖
shadowbeam=暗影激光
emeraldwand=翡翠魔杖
cryoquake=急冻地震
swampdwellerstaff=沼居者法杖
venomshower=毒液法杖
ancientdredgingstaff=远古淤泥法杖
dragonlance=神龙闪
slimestaff=史莱姆法杖
phantompopper=幻影法杖
bloodgrimoire=血之魔典
slimegreatbow=史莱姆巨弓
webweaver=织网者
refractor=折射器
sapphirestaff=蓝宝石法杖
amethyststaff=紫水晶法杖
rubystaff=红宝石法杖
emeraldstaff=翡翠法杖
topazstaff=托帕石法杖
runeboundscepter=符缚权杖
dryadbarrage=树灵弹幕法杖
thesoulstorm=灵魂风暴
ascendedstaff=晋升法杖
throwingweapon=投掷武器
incursionthrowingweapon=副本投掷武器

// Throw weapons
ninjastar=忍者飞镖
icejavelin=冰标枪
woodboomerang=木回旋镖
spiderboomerang=蜘蛛回旋镖
frostboomerang=冰霜回旋镖
voidboomerang=虚空回旋镖
razorbladeboomerang=剃刀回旋镖
tungstenboomerang=钨回旋镖
anchorandchain=船锚与锚链
hook=钩子
ironbomb=铁制炸弹
dynamitestick=炸药
tilebomb=地面炸弹
boxingglovegun=拳击手套枪
glacialboomerang=冰川回旋镖
carapacedagger=甲壳匕首
dragonsrebound=神龙回闪
nightrazorboomerang=暗影回旋镖
chefsspecial=主厨特制
rollingpin=擀面杖
butcherscleaver=屠夫的剁肉刀
snowball=雪球
summonweapon=召唤武器
incursionsummonweapon=副本召唤武器

// Summon weapons
brainonastick=大脑权杖
spiderstaff=蜘蛛权杖
frostpiercer=冰霜穿刺者
magicbranch=魔法枝桠
sentientsword=意剑
slimecanister=史莱姆罐
necroticbow=死灵之弓
reanimationbow=复苏之弓
stabbybush=刀人的灌木
bashybush=敲人的灌木
vulturestaff=秃鹫权杖
piratehook=海盗的钩子
rubyshields=红宝石盾
cryostaff=急冻权杖
phantomcaller=幻影权杖
reaperscall=死神呼唤
swampsgrasp=毒液权杖
skeletonstaff=骷髅权杖
orbofslimes=史莱姆之球
empresscommand=女皇懿旨
crystallizedskull=结晶头骨
dryadbranch=树灵树枝
eyeofthevoid=虚空之眼

// Banners
bannerofspeed=速度旗帜
bannerofdamage=伤害旗帜
bannerofsummonspeed=召唤物速度旗帜
bannerofdefense=防御旗帜

// Misc weapons
forceofwind=狂风之力
blinkscepter=闪光权杖
voidphasingstaff=虚空相位法杖
trinket=饰品

// Trinkets
ninjasmark=忍者徽章
leatherglove=皮革手套
trackerboot=追踪靴
shinebelt=闪耀腰带
explorersatchel=探险家背包
vampiresgift=吸血鬼的馈赠
leatherdashers=皮飞靴
zephyrcharm=微风护石
zephyrboots=微风靴
windboots=疾风靴
hoverboots=悬浮靴
ghostboots=幽灵靴
kineticboots=动力靴
woodshield=木盾
hardenedshield=加固木盾
tungstenshield=钨盾
parrybuckler=格挡圆盾
agedchampionshield=历战王徽章
carapaceshield=甲壳盾
crystalshield=水晶盾
demonclaw=恶魔之爪
polarclaw=极地之爪
fins=鱼鳍
fuzzydice=模糊骰子
noblehorseshoe=贵族马掌
luckycape=幸运披风
piratetelescope=海盗望远镜
regenpendant=再生吊坠
mobilitycloak=速度斗篷
travelercloak=旅行斗篷
explorercloak=探索斗篷
mesmertablet=催眠药片
inducingamulet=诱导护身符
lifeline=命悬一线护符
frozensoul=冰冻魂魄
magicfoci=魔法护符
rangefoci=远程护符
meleefoci=近战护符
summonfoci=召唤护符
balancedfoci=平衡护符
ancientfeather=远古之羽
assassinscowl=刺客兜帽
airvessel=空气罐
miningcharm=采矿护符
minersbouquet=矿工花束
calmingminersbouquet=平静矿工花束
cactusshield=仙人掌之盾
siphonshield=虹吸之盾
sparegemstones=备用宝石
spellstone=符咒石
companionlocket=同伴吊坠
dreamcatcher=捕梦网
nightmaretalisman=梦魇护身符
prophecyslab=预言板
magicmanual=魔法手册
scryingcards=占卜牌
forbiddenspellbook=禁忌咒语书
magicalquiver=魔法箭袋
ammobox=弹药箱
frozenheart=冰冻之心
frozenwave=冰冻之波
spidercharm=蜘蛛之魅
shellofretribution=报复之壳
guardianshell=守护者之壳
bonehilt=骨制手柄
firestone=火焰之石
lifependant=生命吊坠
constructionhammer=建筑锤
telescopicladder=伸缩梯
toolextender=工具扩展器
toolbox=工具箱
itemattractor=物品吸引器
minersprosthetic=矿工义肢
spikedboots=钉靴
spikedbatboots=蝙蝠钉靴
froststone=寒冰之石
frostflame=冰焰之石
balancedfrostfirefoci=平衡冰火护符
calmingrose=平静玫瑰
hysteriatablet=狂暴药片
frenzyorb=狂暴宝珠
scryingmirror=占卜镜
diggingclaw=挖掘之爪
templependant=圣殿吊坠
ancientrelics=远古遗物
gelatincasings=凝胶护套
bloodstonering=血石戒指
claygauntlet=黏土手套
vambrace=臂甲
chainshirt=锁子甲
manica=袖甲
agedchampionscabbard=历战王剑鞘
challengerspauldron=挑战者的肩甲
clockworkheart=发条心
foolsgambit=愚者的赌注
necroticsoulskull=死灵之魂头骨
willowisplantern=鬼火灯笼
essenceofperspective=洞察精华
essenceofprolonging=延时精华
essenceofrebirth=重生精华
spiritboard=占卜板
guardianbracelet=守护者手镯增强
secondwindcharm=回气护符
summonersbestiary=召唤师图鉴
spiritgreaves=灵纹胫甲
cavelingsfoot=穴居者的脚
cavelingscollection=穴居者的收藏
voodooshield=巫毒盾牌
ringoffire=火焰之戒
ringofwater=流水之戒
boots=靴子
bodyarmor=盔甲
helmet=头盔

// Armor
leatherhood=皮兜帽
leathershirt=皮衣
leatherboots=皮靴
clothhat=布帽
clothrobe=布衣
clothboots=布靴
copperhelmet=铜头盔
copperchestplate=铜胸甲
copperboots=铜靴
ironhelmet=铁头盔
ironchestplate=铁胸甲
ironboots=铁靴
goldhelmet=金盔
goldchestplate=金甲
goldboots=金靴
spiderhelmet=蜘蛛头盔
spiderchestplate=蜘蛛胸甲
spiderboots=蜘蛛靴
frosthelmet=冰霜头盔
frosthood=冰霜兜帽
frosthat=冰霜帽
frostchestplate=冰霜胸甲
frostboots=冰霜靴
runichelmet=符文头盔
runichood=符文兜帽
runichat=符文帽
runiccrown=符文皇冠
runicchestplate=符文胸甲
runicboots=符文靴
pharaohsheaddress=法老头冠
pharaohsrobe=法老之袍
pharaohssandals=法老之履
ninjahood=忍者兜帽
ninjarobe=忍者袍
ninjashoes=忍者鞋
demonichelmet=恶魔头盔
demonicchestplate=恶魔胸甲
demonicboots=恶魔靴
voidmask=虚空面罩
voidhat=虚空帽
voidrobe=虚空袍
voidboots=虚空靴
ivyhelmet=常春藤头盔
ivyhood=常春藤兜帽
ivyhat=常春藤帽
ivycirclet=常春藤头环
ivychestplate=常春藤胸甲
ivyboots=常春藤靴
quartzhelmet=石英头盔
quartzcrown=石英皇冠
quartzchestplate=石英胸甲
quartzboots=石英靴
gunslingerhat=牛仔帽
gunslingervest=牛仔马甲
gunslingerboots=牛仔靴
tungstenhelmet=钨头盔
tungstenchestplate=钨胸甲
tungstenboots=钨靴
battlechefhat=战厨帽
battlechefchestplate=战厨胸甲
battlechefboots=战厨靴
shadowhat=暗影帽
shadowhood=暗影兜帽
shadowmantle=暗影斗篷
shadowboots=暗影靴
glacialcirclet=冰川头环
glacialhelmet=冰川头盔
glacialchestplate=冰川胸甲
glacialboots=冰川靴
dryadhelmet=树灵头盔
dryadscarf=树灵围巾
dryadhat=树灵帽
dryadcrown=树灵皇冠
dryadchestplate=树灵胸甲
dryadboots=树灵靴
myceliumhood=菌丝兜帽
myceliumscarf=菌丝围巾
myceliumchestplate=菌丝胸甲
myceliumboots=菌丝靴
agedchampionhelmet=历战王头盔
agedchampionchestplate=历战王胸甲
agedchampiongreaves=历战王胫甲
widowhelmet=寡妇头盔
widowchestplate=寡妇胸甲
widowboots=寡妇靴
ancientfossilmask=远古化石面具
ancientfossilhelmet=远古化石头盔
ancientfossilchestplate=远古化石胸甲
ancientfossilboots=远古化石靴
ancestorshat=先祖之帽
ancestorsrobe=先祖之袍
ancestorsboots=先祖之靴
sharpshooterhat=神射手帽
sharpshootercoat=神射手大衣
sharpshooterboots=神射手靴
slimehat=史莱姆帽
slimehelmet=史莱姆头盔
slimechestplate=史莱姆胸甲
slimeboots=史莱姆靴
nightsteelhelmet=夜钢头盔
nightsteelmask=夜钢面具
nightsteelveil=夜钢面罩
nightsteelcirclet=夜钢头环
nightsteelchestplate=夜钢胸甲
nightsteelboots=夜钢靴
bloodplatecowl=血族头巾
bloodplatechestplate=血族胸甲
bloodplateboots=血族靴
spideritehelmet=蛛裔头盔
spideritehat=蛛裔帽
spideritehood=蛛裔兜帽
spideritecrown=蛛裔皇冠
spideritechestplate=蛛裔胸甲
spideritegreaves=蛛裔胫甲
ravenlordsheaddress=渡鸦领主头饰
ravenlordschestplate=渡鸦领主胸甲
ravenlordsboots=渡鸦领主靴
dawnhelmet=晨光头盔
dawnchestplate=晨光胸甲
dawnboots=晨光靴
duskhelmet=暮光头盔
duskchestplate=暮光胸甲
duskboots=暮光靴
amethysthelmet=紫水晶头盔
sapphireeyepatch=蓝宝石眼罩
emeraldmask=翡翠面具
rubycrown=红宝石皇冠
crystalchestplate=水晶胸甲
crystalboots=水晶靴
arcanichelmet=奥术头盔
arcanicchestplate=奥术胸甲
arcanicboots=奥术靴
runeboundcrown=符缚皇冠
runeboundcrownmask=符缚掩面皇冠
runeboundskullhelmet=符缚骨盔
runeboundhelmet=符缚头盔
runeboundhornhelmet=符缚角盔
runeboundhood=符缚兜帽
runeboundbackbones=符缚脊骨
runeboundrobe=符缚袍
runeboundbonesrobe=符缚骨袍
runeboundleatherchest=符缚皮胸甲
runeboundboots=符缚靴
arachnidhelmet=蛛魔头盔
arachnidchestplate=蛛魔胸甲
arachnidlegs=蛛魔护腿
deepfrosthood=极寒兜帽
deepfrostchestplate=极寒胸甲
deepfrostboots=极寒靴
soulseedcrown=魂源皇冠
soulseedchestplate=魂源胸甲
soulseedboots=魂源靴
soldierhelmet=士兵头盔
soldiercap=士兵帽
soldierchestplate=士兵胸甲
soldierboots=士兵靴
thiefscowl=盗贼兜帽
thiefscloak=盗贼斗篷
thiefsboots=盗贼靴

// Cosmetic Armor
shoes=鞋子
shirt=衬衣
wig=头饰
farmerhat=农夫帽
farmershirt=农夫衬衫
farmershoes=农夫鞋
alchemistglasses=炼金术士眼镜
labcoat=实验室外套
labapron=实验室围裙
labboots=实验室靴
engineergoggles=工程师护目镜
rainhat=雨帽
raincoat=雨衣
rainboots=雨靴
animalkeepershat=饲养员帽
animalkeepershirt=动物饲养员的衬衫
animalkeepershoes=动物饲养员的鞋
smithingapron=熔炉围裙
smithingshoes=熔炉鞋
turban=包头巾
exoticshirt=异域衬衫
exoticshoes=异域鞋
hardhat=安全帽
goldcrown=金皇冠
elderhat=长老帽
eldershirt=长老衬衫
eldershoes=长老鞋
safarihat=游猎帽
safarishirt=游猎衬衫
safarishoes=游猎鞋
minerhat=矿工帽
minershirt=矿工衬衫
minerboots=矿工靴
hunterhood=猎人兜帽
hunterhoodmask=掩面猎人兜帽
huntershirt=猎人衬衫
hunterboots=猎人靴
magehat=法师帽
magerobe=法师袍
mageshoes=法师鞋
witchhat=女巫帽
witchrobe=女巫袍
witchshoes=女巫鞋
cryowitchhat=冰霜女巫帽
cryowitchrobe=冰霜女巫袍
cryowitchshoes=冰霜女巫鞋
crimsonhat=绯红帽
crimsonrobe=绯红袍
crimsonshoes=绯红靴
tophat=大礼帽
blazer=西服
dressshoes=皮鞋
stylistshirt=造型师衬衫
stylistshoes=造型师鞋
merchantshirt=商人衬衫
merchantboots=商人靴
captainshat=船长帽
captainsshirt=船长衬衫
captainsboots=船长靴
pirateeyepatch=海盗眼罩
pirateboots=海盗靴
piratebandana=海盗头巾
piratebandanawitheyepatch=带眼罩的海盗头巾
pirateshirt=海盗衬衫
vulturemask=秃鹫面具
plaguemask=瘟疫面具
plaguerobe=瘟疫长袍
plagueboots=瘟疫靴
surgicalmask=手术面具
trapperhat=捕手帽
horsemask=马面具
horsecostumeshirt=马玩偶上衣
horsecostumeboots=马玩偶靴
christmashat=圣诞帽
partyhat=派对帽
pumpkinmask=南瓜面具
chickenmask=鸡面具
chickencostumeshirt=鸡玩偶上衣
chickencostumeboots=鸡玩偶靴
frogmask=青蛙面具
frogcostumeshirt=青蛙玩偶上衣
frogcostumeboots=青蛙玩偶靴
alienmask=外星人面具
aliencostumeshirt=外星人玩偶上衣
aliencostumeboots=外星人玩偶靴
spacehelmet=太空面具
spacesuit=太空上衣
spaceboots=太空靴
sunglasses=墨镜
jesterhat=小丑帽
jestershirt=小丑上衣
jesterboots=小丑靴
hulahat=夏威夷草帽
hulaskirtwithtop=女式夏威夷草裙
hulaskirt=男式夏威夷草裙
swimsuit=泳装
swimtrunks=泳裤
snowhood=雪兜帽
snowcloak=雪披风
snowboots=雪靴
sailorhat=水手帽
sailorshirt=水手服
sailorshoes=水手靴
empressmask=女皇面具
stylishflower=时尚的花
supporterhelmet=慷慨之盔
supporterchestplate=慷慨之铠
supporterboots=慷慨之靴
spoiledfood=变质的食物

// Food
wheat=小麦
sugarbeet=白甜菜
flour=面粉
sugar=糖
honey=蜂蜜
rice=大米
groundcoffee=咖啡粉
beef=牛肉
rawmutton=生羊肉
rawpork=生猪肉
rabbitleg=兔子腿
duckbreast=鸭胸肉
frogleg=蛙腿
corn=玉米
tomato=番茄
cabbage=卷心菜
chilipepper=辣椒
eggplant=茄子
potato=土豆
carrot=胡萝卜
onion=洋葱
pumpkin=南瓜
strawberry=草莓
beet=红甜菜
apple=苹果
lemon=柠檬
coconut=椰子
banana=香蕉
milk=牛奶
cheese=奶酪
blueberry=蓝莓
raspberry=树莓
blackberry=黑莓
steak=牛排
roastedmutton=烤羊肉
roastedpork=烤猪肉
roastedrabbitleg=烤兔腿
roastedduckbreast=烤鸭胸肉
roastedfrogleg=烤蛙腿
roastedfish=烤鱼
bread=面包
candyapple=糖苹果
popcorn=爆米花
donut=甜甜圈
cookies=曲奇饼
candycane=拐杖糖
meatballs=肉丸子
smokedfillet=熏鱼片
blueberrycake=蓝莓蛋糕
blackberryicecream=黑莓冰淇淋
fruitsmoothie=水果冰沙
fishtaco=墨西哥鱼肉卷
juniorburger=汉堡包
cheeseburger=芝士汉堡
nachos=玉米片
eggplantparmesan=茄子帕尔马干酪
tropicalstew=热带炖菜
fishandchips=炸鱼薯条
freshpotatosalad=新鲜土豆沙拉
hotdog=热狗
ricepudding=大米布丁
minersstew=矿工炖菜
sushirolls=寿司卷
friedpork=炸猪排
bananapudding=香蕉布丁
lemontart=柠檬挞
spaghettibolognese=意大利番茄牛肉面
porktenderloin=猪里脊饭
beefgoulash=牛肉浓汤
shishkebab=羊肉串
pumpkinpie=南瓜饼
sweetlemonade=甘甜柠檬水
strawberrypie=草莓派
blackcoffee=黑咖啡
cappuccino=卡布奇诺
rawchickenleg=生鸡腿
chickendrumstick=熟鸡腿
friedegg=荷包蛋
omelette=煎蛋卷
parisiansteak=法式牛排
chickencutletdish=鸡排饭
dessertpancakes=甜点煎饼
hardboiledegg=白煮蛋
scrambledeggs=炒鸡蛋
deepfriedchicken=炸鸡腿
raspberryjuice=树莓果汁
raspberrymousse=树莓慕斯
raspberryjam=树莓果酱
raspberrypie=树莓派
wildsalad=蔬菜沙拉
rootsalad=根茎蔬菜沙拉
cheesybeetbowl=芝士甜菜
revivalpotion=复活药水
potion=药水

// Potions
healthpotion=生命药水
greaterhealthpotion=高级生命药水
superiorhealthpotion=超级生命药水
manapotion=魔法药水
greatermanapotion=高级魔法药水
superiormanapotion=超级魔法药水
speedpotion=速度药水
greaterspeedpotion=高级速度药水
webpotion=蛛网药水
healthregenpotion=生命恢复药水
greaterhealthregenpotion=高级生命恢复药水
manaregenpotion=魔法恢复药水
greatermanaregenpotion=高级魔法恢复药水
attackspeedpotion=攻速药水
greaterattackspeedpotion=高级攻速药水
invisibilitypotion=隐身药水
fireresistancepotion=防火药水
fishingpotion=钓鱼药水
greaterfishingpotion=高级钓鱼药水
battlepotion=战斗药水
greaterbattlepotion=高级战斗药水
resistancepotion=铁皮药水
greaterresistancepotion=高级铁皮药水
spelunkerpotion=洞穴探险药水
treasurepotion=宝藏药水
passivepotion=和平药水
buildingpotion=建筑药水
greaterbuildingpotion=高级建筑药水
miningpotion=采矿药水
greaterminingpotion=高级采矿药水
thornspotion=荆棘药水
strengthpotion=力量药水
rangerpotion=游侠药水
wisdompotion=智慧药水
minionpotion=召唤物药水
knockbackpotion=击退药水
rapidpotion=迅捷药水
greaterrapidpotion=高级迅捷药水
accuracypotion=精准药水
greateraccuracypotion=高级精准药水

// Consumables
recallscroll=回城卷轴
teleportationscroll=传送卷轴
recallflask=回城魔瓶
stinkflask=恶臭魔瓶
portalflask=传送瓶
enchantingscroll=注魔卷轴
scroll=卷轴
flask=烧瓶
tablet=门牌
SAME_TRANSLATION:formattablet=<biome> <tablet>
gatewaytablet=传送门牌
tier=等级 <tiernumber>
tierandincursiontype=等级 <tiernumber> <incursiontype>

// Misc
craftingguide=合成指南
recipebook=配方书
voidpouch=虚空储物袋
voidbag=虚空背包
coinpouch=钱袋
ammopouch=子弹袋
ammobag=子弹包
potionpouch=药水袋
potionbag=药水包
lunchbox=午餐盒
seedpouch=种子袋
tabletbox=门牌盒
portablemusicplayer=便携音乐播放器
fireworkrocket=烟花袋
woodboat=木船
minecart=矿车
shears=剪刀
bucket=桶
infinitewaterbucket=无尽水桶
rope=绳子
infiniterope=无尽绳子
binoculars=双筒望远镜
telescope=单筒望远镜
strikebanner=罢工旗帜
greenpresent=绿色礼物
bluepresent=蓝色礼物
redpresent=红色礼物
yellowpresent=黄色礼物
christmaspresent=节日礼物
greenwrappingpaper=绿包装纸
bluewrappingpaper=蓝包装纸
redwrappingpaper=红包装纸
yellowwrappingpaper=黄包装纸
landfill=填土方块
grassseed=草籽
overgrowngrassseed=丛生草籽
swampgrassseed=沼泽草草籽
overgrownswampgrassseed=丛生沼泽草草籽
plainsgrassseed=平原草籽
overgrownplainsgrassseed=丛生平原草籽
fertilizer=肥料
mysteriousportal=神秘传送门
royalegg=皇室之蛋
voidcaller=虚空呼唤者
boneoffering=骸骨祭品
spikedfossil=尖锐化石
ancientstatue=远古雕像
shadowgate=暗影之门
icecrown=寒冰皇冠
spiriturn=灵瓮
decayingleaf=腐烂之叶
dragonsouls=龙魂
swarmsignal=蝠群标志
slimeeggs=史莱姆蛋
crownofspiderkin=蛛魔皇冠
villagemap=本地村庄地图
dungeonmap=本地地牢地图
piratemap=本地海盗地图
importedcow=进口牛
importedsheep=进口羊
importedpig=进口猪
mount=坐骑
inefficientfeather=低级羽毛
callofthesea=海之呼唤
jumpingball=跃动球
hoverboard=悬浮板
witchbroom=女巫扫帚
eyeinaportal=传送门中的凝视
weticicle=潮湿冰锥
grizzlycub=灰熊幼崽
exoticseeds=奇异种子
grizzlylunch=灰熊午餐
squeakytoy=嘎吱响的玩具
steelboat=钢船
runeboundboat=符缚船
magicstilts=魔法高跷
petrock=宠物石头
demonheart=恶魔之心
spiderheart=蜘蛛之心
runicheart=符文之心
guardianheart=守护者之心
cryoheart=冰雪之心
wardenheart=典狱长之心
lifeelixir=长生不老药
greaterlifeelixir=极品长生不老药
emptypendant=空挂件
piratesheath=海盗刀鞘
wizardsocket=法师插槽
demoncloak=恶魔斗篷
arcanearmory=奥术军械
abyssalcloak=深渊斗篷
vinyl=<name> 黑胶唱片
unknownvinyl=唱片
relic=神秘遗物
wealth=财富
mobspawnitem=生成 <mob> 的物品

// Quest items
zombiearm=僵尸手臂
goblinring=哥布林戒指
babyswordfish=幼年剑鱼
spiderleg=蜘蛛腿
frozenbeard=冰冻胡须
swampeel=沼泽鳗鱼
babyshark=鲨鱼宝宝
crabclaw=螃蟹爪子
sandray=黄沙射线
fakefangs=虚假獠牙
slimechunk=史莱姆块
enchantedcollar=魔法颈圈
apprenticescroll=学徒卷轴
darkgem=暗黑宝石
slimylauncher=史莱姆发射器
mummysbandage=木乃伊绷带
magicsand=魔力沙子
caveoyster=洞穴牡蛎
capturedspirit=禁锢灵魂
pegleg=木制义肢
eyepatch=眼罩
rumbottle=朗姆酒酒瓶
deepspiritswab=深层灵魂拭子
brokenlimb=断肢
feraltail=野生尾巴
razoricicle=寒冰剃刀
slimesample=史莱姆样本
soakedbow=腐化之弓
wormtooth=蠕虫毒牙
crawlersfoot=爬虫足

// Global ingredients
anysapling=任意树苗
anygrassseed=任意草籽
anylog=任意木头
anystone=任意石头
anycommonfish=任意鱼类
anyrawmeat=任意生肉
bulletuser=任意使用子弹的枪
anycompostable=任意可堆肥物品
anyfruit=任意水果
anycoolingfuel=任意冷却燃料
anytieressence=任意等级 <tier> 的精华
anywrappingpaper=任意包装纸
anycookedfood=任意熟制品
SAME_TRANSLATION:unknowntype=???

[enchantment]
SAME_TRANSLATION:format=<enchantment> <item>
empoweredenchant=强化附魔

// Trinkets
keen=敏捷的
blunt=迟钝的
nimble=迅速的
sluggish=迟缓的
quick=快速的
clumsy=笨拙的
sturdy=坚定的
weak=虚弱的
precise=精确的
sloppy=草率的
bulky=庞大的
puny=微小的
magical=魔法的
draining=枯竭的
tenacious=顽强的
flimsy=脆弱的
tough=坚韧的
fragile=易碎的

// Sword/melee weapon enchants
berserk=狂暴的
adamant=坚定的
agile=敏捷的
harmful=有力的
grand=巨大的
docile=温顺的
shoddy=劣质的
amateur=业余的
envious=嫉妒的

// Ranged weapon enchants
masterful=大师的
skillful=熟练的
tightened=牢固的
modern=现代的
trained=训练有素的
loose=松散的
eroding=宽松的
primitive=原始的
faulty=错误的

// Magic weapon enchants
divine=神圣的
wrathful=愤怒的
wise=明智的
adept=熟练的
apprentice=学徒的
decaying=腐朽的
novice=新手的
daft=愚蠢的
corrupt=腐化的

// Summon weapon enchants
savage=野蛮的
athletic=健壮的
mindful=智慧的
proud=荣耀的
aware=意识的
spoiled=过期的
sick=生病的
spiteful=恶意的
naive=天真的

// Tool enchants
master=大师的
shining=闪耀的
sharp=锋利的
absurd=晦涩的
used=破旧的
